傌	㐷
㑶	㐹
偑	㐽
㑳	㑇
倲	㑈
㑯	㑔
儸	㑩
𠗣	㓆
劏	㓥
劃	㓰
劚	㔉
噚	㖊
喎	㖞
㘔	㗷
㘚	㘎
㜄	㚯
媰	㛀
𡞵	㛟
𡢃	㛠
㜏	㛣
孋	㛤
𡠹	㛿
㠏	㟆
𡾱	㟜
嵾	㟥
幓	㡎
㥮	㤘
懤	㤽
慺	㥪
掆	㧏
㩳	㧐
撝	㧑
擓	㧟
擽	㧰
㩜	㨫
棡	㭎
椲	㭏
𣙎	㭣
樢	㭤
樫	㭴
殰	㱩
殨	㱮
瀇	㲿
濧	㳔
灡	㳕
澾	㳠
濄	㳡
𣾷	㳢
瀰	㳽
潚	㴋
鸂	㶉
燶	㶶
煱	㶽
獱	㺍
璯	㻅
𤫩	㻏
𤪺	㻘
䁻	䀥
瞜	䁖
碽	䂵
磾	䃅
稏	䅉
穇	䅟
𥢢	䅪
筴	䇲
籔	䉤
䊷	䌶
紬	䌷
縳	䌸
絅	䌹
䋙	䌺
䋚	䌻
綐	䌼
綵	䌽
䋻	䌾
䋹	䌿
繿	䍀
繸	䍁
䍦	䍠
䎱	䎬
膞	䏝
𦪙	䑽
薵	䓓
薳	䓕
藭	䓖
罃	䓨
螮	䗖
𧝞	䘛
𧜗	䘞
𧜵	䙊
䙡	䙌
襬	䙓
訢	䜣
鿁	䜤
𧩙	䜥
䜀	䜧
讌	䜩
貙	䝙
𧵳	䞌
䝼	䞍
𧶧	䞎
賰	䞐
躎	䟢
𨊰	䢀
𨊸	䢁
𨋢	䢂
釾	䥺
鏺	䥽
䥱	䥾
𨯅	䥿
𨦫	䦀
𨧜	䦁
䥇	䦂
鐯	䦃
鐥	䦅
钁	䦆
䦛	䦶
䦟	䦷
靦	䩄
𩞯	䭪
𩣑	䯃
騧	䯄
䯀	䯅
䱽	䲝
𩶘	䲞
鮣	䲟
鰆	䲠
鰌	䲡
鰧	䲢
䱷	䲣
鳾	䴓
鵁	䴔
鴷	䴕
鶄	䴖
鶪	䴗
鷈	䴘
鷉	䴘
鷿	䴙
鸊	䴙
龑	䶮
醜	丑
専	专
業	业
叢	丛
東	东
糸	丝
丟	丢
両	两
厳	严
喪	丧
個	个
箇	个
豊	丰
臨	临
為	为
麗	丽
舉	举
麼	么
義	义
烏	乌
楽	乐
喬	乔
習	习
鄉	乡
書	书
買	买
瞭	了
於	于
虧	亏
雲	云
亙	亘
亜	亚
產	产
畝	亩
親	亲
褻	亵
嚲	亸
億	亿
僅	仅
僕	仆
讎	仇
従	从
侖	仑
崙	仑
倉	仓
儀	仪
們	们
価	价
彷	仿
衆	众
優	优
夥	伙
傴	伛
傘	伞
偉	伟
伝	传
俥	伡
俔	伣
傷	伤
倀	伥
倫	伦
傖	伧
偽	伪
佇	伫
彿	仏
傭	佣
僉	佥
俠	侠
侶	侣
僥	侥
偵	侦
側	侧
僑	侨
儈	侩
儕	侪
儂	侬
儘	侭
儁	俊
俁	俣
儔	俦
儼	俨
倆	俩
儷	俪
倈	俫
倹	俭
脩	修
藉	借
債	债
傾	倾
傯	偬
僂	偻
僨	偾
償	偿
儎	傤
儻	傥
儐	傧
儲	储
儺	傩
殭	僵
児	儿
剋	克
兌	兑
兗	兖
蘭	兰
関	关
興	兴
茲	兹
養	养
獣	兽
囅	冁
內	内
岡	冈
軍	军
農	农
鼕	冬
馮	冯
衝	冲
沖	冲
決	决
況	况
凍	冻
浄	净
悽	凄
淒	凄
準	准
涼	凉
淩	凌
減	减
湊	凑
凜	凛
幾	几
機	几
鳳	凤
鳧	凫
憑	凭
凱	凯
兇	凶
齣	出
擊	击
鑿	凿
芻	刍
劃	划
劉	刘
則	则
剛	刚
創	创
刪	删
別	别
彆	别
剗	刬
剄	刭
颳	刮
製	制
剎	刹
劊	刽
㓨	刾
劌	刿
剴	剀
剤	剂
剮	剐
剣	剑
剝	剥
劇	剧
勧	劝
辦	办
務	务
勱	劢
動	动
勁	劲
労	劳
勢	势
勲	勋
勛	勋
勩	勚
勻	匀
匭	匦
匱	匮
韆	千
昇	升
華	华
協	协
単	单
売	卖
蔔	卜
佔	占
盧	卢
滷	卤
鹵	卤
臥	卧
衛	卫
卻	却
捲	巻
巹	卺
廠	厂
庁	厅
歷	历
曆	历
厲	厉
圧	压
厭	厌
厙	厍
龎	厐
廁	厕
釐	厘
廂	厢
厴	厣
廈	厦
廚	厨
廄	厩
廝	厮
県	县
叄	叁
蔘	参
靉	叆
靆	叇
発	发
髪	发
変	变
敘	叙
畳	叠
隻	只
祇	只
檯	台
颱	台
葉	叶
嘆	叹
歎	叹
嘰	叽
籲	吁
閤	合
弔	吊
衕	同
後	后
嚮	向
曏	向
嚇	吓
呂	吕
嗎	吗
唚	吣
噸	吨
聴	听
啓	启
吳	吴
吶	呐
嘸	呒
囈	呓
嘔	呕
嚦	呖
唄	呗
員	员
咼	呙
嗆	呛
嗚	呜
週	周
賙	周
詠	咏
嚨	咙
嚀	咛
噝	咝
吒	咤
諮	咨
鹹	咸
嚥	咽
鬨	哄
響	响
啞	哑
噠	哒
嘵	哓
嗶	哔
噦	哕
譁	哗
嘩	哗
噲	哙
嚌	哜
噥	哝
喲	哟
脣	唇
嘜	唛
嗊	唝
嘮	唠
啢	唡
嗩	唢
喚	唤
嘖	啧
嗇	啬
囀	啭
齧	啮
嚙	啮
嘓	啯
囉	啰
嘽	啴
嘯	啸
餵	喂
噴	喷
嘍	喽
嚳	喾
囁	嗫
噯	嗳
噓	嘘
嚶	嘤
嚕	噜
譟	噪
囂	嚣
迴	回
団	团
糰	团
園	园
睏	困
囪	囱
囲	围
圇	囵
図	图
円	圆
聖	圣
壙	圹
場	场
阪	坂
壊	坏
座	坐
塊	块
堅	坚
壇	坛
罈	坛
壢	坜
壩	坝
塢	坞
墳	坟
墜	坠
壟	垄
壠	垅
壚	垆
塁	垒
墾	垦
堊	垩
墊	垫
埡	垭
墶	垯
壋	垱
塏	垲
堖	垴
塒	埘
壎	埙
塤	埙
堝	埚
垵	埯
塹	堑
壪	塆
牆	墙
殻	壳
壺	壶
壼	壸
処	处
備	备
復	复
複	复
覆	复
夠	够
伕	夫
頭	头
誇	夸
夾	夹
奪	夺
奩	奁
奐	奂
奮	奋
獎	奖
姦	奸
妝	妆
婦	妇
媽	妈
嫵	妩
嫗	妪
嬀	妫
姍	姗
薑	姜
奼	姹
婁	娄
婭	娅
嬈	娆
嬌	娇
孌	娈
嬢	娘
娛	娱
媧	娲
嫺	娴
嫻	娴
嫿	婳
嬰	婴
嬋	婵
嬸	婶
媼	媪
嬃	媭
嬡	嫒
嬪	嫔
嬙	嫱
嬤	嬷
孫	孙
孿	孪
寧	宁
甯	宁
実	实
寵	宠
審	审
憲	宪
宮	宫
傢	家
寬	宽
賓	宾
対	对
尋	寻
導	导
爾	尔
塵	尘
嘗	尝
嚐	尝
堯	尧
尷	尴
屍	尸
儘	尽
侷	局
層	层
屓	屃
屜	屉
屢	屡
屨	屦
嶼	屿
歲	岁
豈	岂
嶇	岖
崗	岗
峴	岘
嶴	岙
嵐	岚
島	岛
巖	岩
嶺	岭
崬	岽
巋	岿
嶨	峃
嶧	峄
嶢	峣
嶠	峤
崢	峥
巒	峦
峯	峰
嶗	崂
崍	崃
嶮	崄
嶄	崭
嶸	嵘
嶔	嵚
嶁	嵝
巔	巅
鉅	巨
鞏	巩
巰	巯
幣	币
佈	布
帥	帅
師	师
幃	帏
帳	帐
簾	帘
幟	帜
帯	带
幀	帧
蓆	席
幫	帮
幬	帱
幘	帻
幗	帼
冪	幂
襆	幞
幹	干
乾	干
並	并
併	并
倖	幸
広	广
荘	庄
慶	庆
牀	床
廬	庐
廡	庑
庫	库
応	应
廟	庙
龐	庞
廃	废
菴	庵
廎	庼
廩	廪
開	开
異	异
棄	弃
弒	弑
張	张
彌	弥
瀰	弥
絃	弦
弳	弪
彎	弯
弾	弹
強	强
帰	归
噹	当
錄	录
彔	录
彠	彟
彥	彦
彲	彨
綵	彩
徹	彻
徵	征
徠	徕
禦	御
憶	忆
懺	忏
誌	志
憂	忧
唸	念
愾	忾
懐	怀
態	态
慫	怂
憮	怃
慪	怄
悵	怅
愴	怆
憐	怜
総	总
懟	怼
懌	怿
卹	恤
懇	恳
悪	恶
噁	恶
慟	恸
懨	恹
愷	恺
惻	恻
悩	恼
惲	恽
悅	悦
愨	悫
懸	悬
慳	悭
悞	悮
憫	悯
驚	惊
懼	惧
懲	惩
憊	惫
愜	惬
慚	惭
憚	惮
慣	惯
癒	愈
慍	愠
憤	愤
憒	愦
願	愿
懾	慑
憖	慭
懣	懑
懶	懒
懍	懔
戇	戆
戔	戋
戯	戏
戧	戗
戦	战
慼	戚
鏚	戚
戩	戬
戱	戯
戶	户
纔	才
紮	扎
撲	扑
託	托
釦	扣
執	执
拡	扩
捫	扪
掃	扫
揚	扬
擾	扰
摺	折
撫	抚
拋	抛
摶	抟
摳	抠
掄	抡
搶	抢
護	护
報	报
擡	抬
牴	抵
柺	拐
擬	拟
攏	拢
揀	拣
擁	拥
攔	拦
擰	拧
撥	拨
択	择
掛	挂
摯	挚
攣	挛
掗	挜
撾	挝
撻	挞
撓	挠
擋	挡
撟	挢
掙	挣
擠	挤
揮	挥
撏	挦
捱	挨
輓	挽
挩	捝
撈	捞
損	损
撿	捡
換	换
搗	捣
拠	据
擄	掳
摑	掴
擲	掷
撣	掸
摻	掺
摜	掼
攬	揽
搵	揾
撳	揿
攙	搀
擱	搁
摟	搂
揯	搄
攪	搅
蒐	捜
攜	携
摂	摄
攄	摅
擺	摆
襬	摆
揺	摇
擯	摈
攤	摊
攖	撄
撐	撑
攆	撵
擷	撷
擼	撸
攛	撺
㩵	擜
擻	擞
攢	攒
敵	敌
敓	敚
斂	敛
斆	敩
斎	斋
斕	斓
鬥	斗
斬	斩
無	无
時	时
曠	旷
暘	旸
崑	昆
曇	昙
暱	昵
曨	昽
顕	显
晉	晋
曬	晒
暁	晓
曄	晔
暈	晕
暉	晖
暫	暂
𣈶	暅
闇	暗
曖	暧
麴	曲
術	术
朮	术
硃	朱
樸	朴
機	机
殺	杀
雑	杂
権	权
桿	杆
槓	杠
楊	杨
榪	杩
盃	杯
傑	杰
鬆	松
闆	板
極	极
構	构
樅	枞
棗	枣
櫪	枥
梘	枧
棖	枨
槍	枪
楓	枫
梟	枭
櫃	柜
檸	柠
檉	柽
梔	栀
柵	栅
標	标
桟	栈
櫛	栉
櫳	栊
棟	栋
櫨	栌
櫟	栎
欄	栏
樹	树
棲	栖
慄	栗
様	样
覈	核
欒	栾
椏	桠
橈	桡
楨	桢
檔	档
榿	桤
橋	桥
樺	桦
檜	桧
槳	桨
樁	桩
樳	桪
樑	梁
夢	梦
檮	梼
棶	梾
槤	梿
検	检
梲	棁
櫺	棂
欞	棂
槨	椁
槼	椝
櫝	椟
槧	椠
槶	椢
欏	椤
樿	椫
橢	椭
槮	椮
欖	榄
榲	榅
櫬	榇
櫚	榈
櫸	榉
樧	榝
檟	槚
檻	槛
檳	槟
櫧	槠
橫	横
檣	樯
桜	樱
櫫	橥
櫥	橱
櫓	橹
櫞	橼
檁	檩
歓	欢
歟	欤
慾	欲
殲	歼
歿	殁
殤	殇
殞	殒
殮	殓
殫	殚
殯	殡
毀	毁
燬	毁
譭	毁
轂	毂
畢	毕
斃	毙
氈	毡
毿	毵
毿	毶
𣯶	毶
氌	氇
気	气
氫	氢
氬	氩
氳	氲
匯	汇
彙	汇
漢	汉
湯	汤
洶	汹
瀋	沈
溝	沟
灃	沣
漚	沤
瀝	沥
淪	沦
滄	沧
渢	沨
潙	沩
滬	沪
氾	泛
汎	泛
濘	泞
註	注
淚	泪
澩	泶
滝	泷
瀘	泸
濼	泺
瀉	泻
潑	泼
沢	泽
涇	泾
潔	洁
灑	洒
窪	洼
浹	浃
漿	浆
澆	浇
湞	浈
溮	浉
濁	浊
測	测
澮	浍
済	济
瀏	浏
滻	浐
渾	浑
滸	浒
濃	浓
潯	浔
濜	浕
塗	涂
涗	涚
濤	涛
澇	涝
淶	涞
漣	涟
潿	涠
渦	涡
溳	涢
渙	涣
滌	涤
潤	润
澗	涧
漲	涨
澀	涩
澱	淀
淵	渊
淥	渌
漬	渍
瀆	渎
漸	渐
澠	渑
漁	渔
瀋	渖
滲	渗
溫	温
遊	游
溼	湿
濚	溁
潰	溃
濺	溅
漵	溆
漊	溇
潷	滗
滾	滚
灩	滟
灧	滟
灄	滠
満	满
瀅	滢
濾	滤
濫	滥
灤	滦
浜	滨
灘	滩
澦	滪
灕	漓
瀠	潆
瀟	潇
瀲	潋
濰	潍
瀦	潴
瀂	澛
瀾	澜
瀨	濑
瀕	濒
灝	灏
滅	灭
霊	灵
竈	灶
災	灾
燦	灿
煬	炀
燉	炖
煒	炜
熗	炝
煉	炼
鍊	炼
熾	炽
爍	烁
爛	烂
烴	烃
燭	烛
煙	烟
菸	烟
煩	烦
焼	烧
燁	烨
燴	烩
燙	烫
燼	烬
熱	热
煥	焕
燜	焖
燾	焘
熅	煴
薰	熏
燻	熏
愛	爱
爺	爷
牘	牍
犛	牦
牽	牵
犠	牺
犢	犊
狀	状
獷	犷
獁	犸
猶	犹
狽	狈
獮	狝
獰	狞
獅	狮
獪	狯
猙	狰
獄	狱
猻	狲
獫	猃
猟	猎
獼	猕
玀	猡
豬	猪
貓	猫
蝟	猬
獺	獭
璣	玑
璵	玙
瑒	玚
瑪	玛
瑋	玮
環	环
現	现
瑲	玱
璽	玺
琺	珐
瓏	珑
璫	珰
琿	珲
璡	琎
璉	琏
瑣	琐
瓊	琼
瑤	瑶
璦	瑷
璸	瑸
瓔	璎
瓚	瓒
甕	瓮
甌	瓯
電	电
暢	畅
疇	畴
癤	疖
療	疗
瘧	疟
癘	疠
瘍	疡
癧	疬
瘲	疭
瘡	疮
瘋	疯
皰	疱
痾	疴
癥	症
癰	痈
痙	痉
癢	痒
瘂	痖
癆	痨
瘓	痪
癇	痫
癉	瘅
瘮	瘆
瘞	瘗
瘻	瘘
癟	瘪
癱	瘫
癮	瘾
癭	瘿
癩	癞
癬	癣
癲	癫
皁	皂
皚	皑
皺	皱
皸	皲
盞	盏
塩	盐
監	监
蓋	盖
盤	盘
瞘	眍
眥	眦
矓	眬
睜	睁
睞	睐
瞼	睑
瞶	瞆
瞞	瞒
矚	瞩
榘	矩
矯	矫
磯	矶
礬	矾
礦	矿
碭	砀
碼	码
磚	砖
硨	砗
硯	砚
碸	砜
礪	砺
礱	砻
礫	砾
礎	础
硜	硁
碩	硕
硤	硖
磽	硗
磑	硙
礄	硚
確	确
磠	硵
礆	硷
礙	碍
磧	碛
磣	碜
鹼	碱
禡	祃
禕	祎
禰	祢
禎	祯
禱	祷
禍	祸
稟	禀
祿	禄
離	离
俬	私
禿	秃
稈	秆
鞦	秋
種	种
積	积
穢	秽
穠	秾
穭	稆
稅	税
穌	稣
穏	稳
穡	穑
繐	穂
穭	穞
窮	穷
竅	窍
窵	窎
窯	窑
竄	窜
窩	窝
窺	窥
竇	窦
窶	窭
豎	竖
競	竞
篤	笃
筍	笋
筆	笔
筧	笕
箋	笺
籠	笼
籩	笾
築	筑
篳	筚
篩	筛
簹	筜
箏	筝
籌	筹
篔	筼
籤	签
簽	签
篠	筿
簡	简
籙	箓
簀	箦
篋	箧
籜	箨
籮	箩
簞	箪
簫	箫
簣	篑
簍	篓
籃	篮
籛	篯
籬	篱
籪	簖
籟	籁
糴	籴
類	类
秈	籼
糶	粜
糲	粝
粵	粤
糞	粪
糧	粮
糉	粽
糝	糁
餱	糇
餈	糍
係	系
繫	系
緊	紧
縶	絷
縕	緼
緪	縆
糹	纟
糾	纠
紆	纡
紅	红
紂	纣
繊	纤
縴	纤
紇	纥
約	约
級	级
紈	纨
纊	纩
紀	纪
紉	纫
緯	纬
紜	纭
紘	纮
純	纯
紕	纰
紗	纱
綱	纲
納	纳
紝	纴
縦	纵
綸	纶
紛	纷
紙	纸
紋	纹
紡	纺
紵	纻
紖	纼
紐	纽
鈕	纽
紓	纾
線	线
紺	绀
紲	绁
紱	绂
練	练
組	组
紳	绅
細	细
織	织
終	终
縐	绉
絆	绊
紼	绋
絀	绌
紹	绍
繹	绎
経	经
紿	绐
綁	绑
絨	绒
結	结
絝	绔
繞	绕
絰	绖
絎	绗
絵	绘
給	给
絢	绚
絳	绛
絡	络
絕	绝
絞	绞
統	统
綆	绠
綃	绡
絹	绢
繡	绣
綌	绤
綏	绥
絛	绦
継	继
綈	绨
績	绩
緒	绪
綾	绫
緓	绬
続	续
綺	绮
緋	绯
綽	绰
鞝	绱
緔	绱
緄	绲
縄	绳
維	维
綿	绵
綬	绶
繃	绷
綳	绷
綢	绸
綯	绹
綹	绺
綣	绻
綜	综
綻	绽
綰	绾
綠	绿
綴	缀
緇	缁
緙	缂
緗	缃
緘	缄
緬	缅
纜	缆
緹	缇
緲	缈
緝	缉
縕	缊
繢	缋
緦	缌
綞	缍
緞	缎
緶	缏
線	缐
緱	缑
縋	缒
緩	缓
締	缔
縷	缕
編	编
緡	缗
緣	缘
縉	缙
縛	缚
縟	缛
縝	缜
縫	缝
縗	缞
縞	缟
纏	缠
縭	缡
縊	缢
縑	缣
繽	缤
縹	缥
縵	缦
縲	缧
纓	缨
縮	缩
繆	缪
繅	缫
纈	缬
繚	缭
繕	缮
繒	缯
繮	缰
繾	缱
繰	缲
繯	缳
繳	缴
纘	缵
罌	罂
網	网
羅	罗
罰	罚
罷	罢
羆	罴
羈	羁
羥	羟
羨	羡
羣	群
翹	翘
翽	翙
翬	翚
耮	耢
耬	耧
聳	耸
恥	耻
聶	聂
聾	聋
職	职
聹	聍
聯	联
聵	聩
聰	聪
粛	肃
腸	肠
膚	肤
骯	肮
餚	肴
腎	肾
腫	肿
脹	胀
脅	胁
冑	胄
揹	背
勝	胜
鬍	胡
衚	胡
朧	胧
腖	胨
臚	胪
脛	胫
膠	胶
脈	脉
膾	脍
髒	脏
臓	脏
臍	脐
脳	脑
膿	脓
臠	脔
腳	脚
脫	脱
腡	脶
臉	脸
臘	腊
醃	腌
膕	腘
齶	腭
膩	腻
靦	腼
膃	腽
騰	腾
臏	膑
羶	膻
臢	臜
緻	致
輿	舆
捨	舎
艤	舣
艦	舰
艙	舱
艫	舻
艱	艰
豔	艳
艷	艳
芸	艺
節	节
羋	芈
薌	芗
蕪	芜
蘆	芦
菕	芲
蕓	芸
蓯	苁
葦	苇
藶	苈
莧	苋
萇	苌
蒼	苍
苧	苎
蘇	苏
甦	苏
囌	苏
薹	苔
檾	苘
薴	苧
蘋	苹
範	范
蘢	茏
蔦	茑
塋	茔
煢	茕
繭	茧
荊	荆
薦	荐
薘	荙
莢	荚
蕘	荛
蓽	荜
萴	荝
蕎	荞
薈	荟
薺	荠
蕩	荡
盪	荡
栄	荣
葷	荤
滎	荥
犖	荦
熒	荧
蕁	荨
藎	荩
蓀	荪
蔭	荫
廕	荫
蕒	荬
葒	荭
葤	荮
薬	药
葯	药
蒞	莅
萊	莱
蓮	莲
蒔	莳
萵	莴
薟	莶
獲	获
穫	获
蕕	莸
瑩	莹
鶯	莺
蓴	莼
蘀	萚
蘿	萝
蛍	萤
営	营
縈	萦
蕭	萧
薩	萨
蔥	葱
蒕	蒀
蕆	蒇
蕢	蒉
蔣	蒋
蔞	蒌
醟	蒏
矇	蒙
濛	蒙
懞	蒙
藍	蓝
薊	蓟
蘺	蓠
蕷	蓣
鎣	蓥
驀	蓦
虆	蔂
衊	蔑
薔	蔷
蘞	蔹
藺	蔺
藹	蔼
薀	蕰
蘄	蕲
蘊	蕴
藪	薮
蘚	藓
蘊	藴
櫱	蘖
虜	虏
慮	虑
虛	虚
虯	虬
蟣	虮
蝨	虱
雖	虽
蝦	虾
蠆	虿
蝕	蚀
蟻	蚁
螞	蚂
蠁	蚃
蠔	蚝
蜆	蚬
蠱	蛊
蠣	蛎
蟶	蛏
蟄	蛰
蛺	蛱
蟯	蛲
螄	蛳
蠐	蛴
蛻	蜕
蝸	蜗
蠟	蜡
蠅	蝇
蟈	蝈
蟬	蝉
蠍	蝎
螻	蝼
蠑	蝾
螿	螀
蟎	螨
蠨	蟏
釁	衅
銜	衔
補	补
錶	表
襯	衬
袞	衮
襖	袄
嫋	袅
裊	袅
褘	袆
襪	袜
襲	袭
襏	袯
襠	裆
褌	裈
褳	裢
襝	裣
褲	裤
襉	裥
襇	裥
褸	褛
襤	褴
襴	襕
見	见
観	观
覎	觃
規	规
覓	觅
視	视
覘	觇
覧	览
覚	觉
覬	觊
覡	觋
覿	觌
覥	觍
覦	觎
覯	觏
覲	觐
覷	觑
觴	觞
觶	觯
誾	訚
讋	詟
謄	誊
訁	讠
計	计
訂	订
訃	讣
認	认
譏	讥
訐	讦
訌	讧
討	讨
譲	让
訕	讪
訖	讫
託	讬
訓	训
議	议
訊	讯
記	记
訒	讱
講	讲
諱	讳
謳	讴
詎	讵
訝	讶
訥	讷
許	许
訛	讹
論	论
訩	讻
訟	讼
諷	讽
設	设
訪	访
訣	诀
証	证
証	证
詁	诂
訶	诃
評	评
詛	诅
識	识
詗	诇
詐	诈
訴	诉
診	诊
詆	诋
謅	诌
詞	词
詘	诎
詔	诏
詖	诐
訳	译
詒	诒
誆	诓
誄	诔
試	试
詿	诖
詩	诗
詰	诘
詼	诙
誠	诚
誅	诛
詵	诜
話	话
誕	诞
詬	诟
詮	诠
詭	诡
詢	询
詣	诣
諍	诤
該	该
詳	详
詫	诧
諢	诨
詡	诩
譸	诪
誡	诫
誣	诬
語	语
誚	诮
誤	误
誥	诰
誘	诱
誨	诲
誑	诳
說	说
誦	诵
誒	诶
請	请
諸	诸
諏	诹
諾	诺
読	读
諑	诼
誹	诽
課	课
諉	诿
諛	谀
誰	谁
諗	谂
調	调
諂	谄
諒	谅
諄	谆
誶	谇
談	谈
讅	谉
誼	谊
謀	谋
諶	谌
諜	谍
謊	谎
諫	谏
諧	谐
謔	谑
謁	谒
謂	谓
諤	谔
諭	谕
諼	谖
讒	谗
諮	谘
諳	谙
諺	谚
諦	谛
謎	谜
諞	谝
諝	谞
謨	谟
讜	谠
謖	谡
謝	谢
謡	谣
謗	谤
諡	谥
謚	谥
謙	谦
謐	谧
謹	谨
謾	谩
謫	谪
譾	谫
謬	谬
譚	谭
譖	谮
譙	谯
讕	谰
譜	谱
譎	谲
讞	谳
譴	谴
譫	谵
讖	谶
穀	谷
豶	豮
貝	贝
貞	贞
負	负
貟	贠
貢	贡
財	财
責	责
賢	贤
敗	败
賬	账
貨	货
質	质
販	贩
貪	贪
貧	贫
貶	贬
購	购
貯	贮
貫	贯
弐	贰
賤	贱
賁	贲
貰	贳
貼	贴
貴	贵
貺	贶
貸	贷
貿	贸
費	费
賀	贺
貽	贻
賊	贼
贄	贽
賈	贾
賄	贿
貲	赀
賃	赁
賂	赂
贓	赃
資	资
賅	赅
贐	赆
賕	赇
賑	赈
賚	赉
賒	赊
賦	赋
賭	赌
齎	赍
贖	赎
賞	赏
賜	赐
贔	赑
賙	赒
賡	赓
賠	赔
賧	赕
賴	赖
賵	赗
贅	赘
賻	赙
賺	赚
賽	赛
賾	赜
贗	赝
贋	赝
賛	赞
讚	赞
贇	赟
贈	赠
贍	赡
贏	赢
贛	赣
赬	赪
趙	赵
趕	赶
趨	趋
趲	趱
躉	趸
躍	跃
蹌	跄
躒	跞
躂	跶
蹺	跷
蹕	跸
躚	跹
躋	跻
躊	踌
蹤	踪
躓	踬
躑	踯
躡	蹑
蹣	蹒
躕	蹰
躥	蹿
躪	躏
躦	躜
軀	躯
轀	輼
車	车
軋	轧
軌	轨
軒	轩
軑	轪
軔	轫
転	转
軛	轭
輪	轮
軟	软
轟	轰
軲	轱
軻	轲
轤	轳
軸	轴
軹	轵
軼	轶
軤	轷
軫	轸
轢	轹
軺	轺
軽	轻
軾	轼
載	载
輊	轾
轎	轿
輈	辀
輇	辁
輅	辂
較	较
輒	辄
輔	辅
輛	辆
輦	辇
輩	辈
輝	辉
輥	辊
輞	辋
輬	辌
輟	辍
輜	辎
輳	辏
輻	辐
輯	辑
轀	辒
輸	输
轡	辔
轅	辕
轄	辖
輾	辗
轆	辘
轍	辙
轔	辚
闢	辟
弁	辩
辮	辫
辺	边
遼	辽
達	达
遷	迁
過	过
邁	迈
運	运
還	还
這	这
進	进
遠	远
違	违
連	连
遅	迟
邇	迩
逕	迳
跡	迹
蹟	迹
適	适
選	选
遜	逊
逓	递
邐	逦
邏	逻
遺	遗
遙	遥
鄧	邓
鄺	邝
鄔	邬
郵	邮
鄒	邹
鄴	邺
鄰	邻
鬱	郁
郟	郏
鄶	郐
鄭	郑
鄆	郓
酈	郦
鄖	郧
鄲	郸
酇	酂
醞	酝
醱	酦
醬	酱
痠	酸
釅	酽
釃	酾
醸	酿
醞	醖
採	采
寀	采
釈	释
裏	里
鑑	鉴
鑒	鉴
鑾	銮
鏨	錾
釒	钅
釓	钆
釔	钇
針	针
鍼	针
釘	钉
釗	钊
釙	钋
釕	钌
釷	钍
釺	钎
釧	钏
釤	钐
鈒	钑
釩	钒
釣	钓
鍆	钔
釹	钕
鍚	钖
釵	钗
鈃	钘
鈣	钙
鈈	钚
鈦	钛
鉅	钜
鈍	钝
鈔	钞
鍾	钟
鐘	钟
鈡	钟
鈉	钠
鋇	钡
鋼	钢
鈑	钣
鈐	钤
鑰	钥
鈅	钥
欽	钦
鈞	钧
鎢	钨
鉤	钩
鈧	钪
鈁	钫
鍅	钫
鈥	钬
鈄	钭
鈕	钮
鈀	钯
鈺	钰
銭	钱
鉦	钲
鉗	钳
鈷	钴
鉢	钵
鈳	钶
鉕	钷
鈽	钸
鈸	钹
鉞	钺
鑽	钻
鉆	钻
鉬	钼
鉭	钽
鉀	钾
鈿	钿
鈾	铀
鉄	铁
鉑	铂
鈴	铃
鑠	铄
鉛	铅
鉚	铆
鉋	铇
鈰	铈
鉉	铉
鉈	铊
鉍	铋
鈮	铌
鈹	铍
鐸	铎
鉶	铏
銬	铐
銠	铑
鉺	铒
鋩	铓
錏	铔
銪	铕
鋮	铖
鋏	铗
鋣	铘
鐃	铙
銍	铚
鐺	铛
銅	铜
鋁	铝
銱	铞
銦	铟
鎧	铠
鍘	铡
銖	铢
銑	铣
鋌	铤
銩	铥
銛	铦
鏵	铧
銓	铨
鎩	铩
鉿	铪
銚	铫
鉻	铬
銘	铭
錚	铮
銫	铯
鉸	铰
銥	铱
鏟	铲
剷	铲
銃	铳
鐋	铴
銨	铵
銀	银
銣	铷
鋳	铸
鐒	铹
鋪	铺
鋙	铻
錸	铼
鋱	铽
鏈	链
鍊	链
鏗	铿
銷	销
鎖	锁
鋰	锂
鋥	锃
鋤	锄
鍋	锅
鋯	锆
鋨	锇
鏽	锈
銼	锉
鋝	锊
鋒	锋
鋅	锌
鋶	锍
鐦	锎
鐗	锏
鐧	锏
銳	锐
銻	锑
鋃	锒
鋟	锓
鋦	锔
錒	锕
錆	锖
鍺	锗
鍩	锘
錯	错
錨	锚
錛	锛
錡	锜
鍀	锝
錁	锞
錕	锟
錩	锠
錫	锡
錮	锢
鑼	锣
錘	锤
錐	锥
錦	锦
鑕	锧
杴	锨
鍁	锨
錈	锩
鍃	锪
錇	锫
鉳	锫
錟	锬
錠	锭
鍵	键
鋸	锯
錳	锰
錙	锱
鍥	锲
鍈	锳
鍇	锴
鏘	锵
鍶	锶
鍔	锷
鍤	锸
鍬	锹
鍾	锺
鍛	锻
鎪	锼
鍠	锽
鍰	锾
鎄	锿
鑀	锿
鍍	镀
鎂	镁
鏤	镂
鎡	镃
鐨	镄
鎇	镅
鋂	镅
鏌	镆
鎮	镇
鎛	镈
鎘	镉
鑷	镊
钂	镋
鎲	镋
鐫	镌
鎳	镍
鎿	镎
錼	镎
鎦	镏
鎬	镐
鎊	镑
鎰	镒
鎵	镓
鑌	镔
鎔	镕
鏢	镖
鏜	镗
鏝	镘
鏍	镙
鏰	镚
鏞	镛
鏡	镜
鏑	镝
鏃	镞
鏇	镟
鏐	镠
鐔	镡
钁	镢
鐝	镢
鐐	镣
鏷	镤
鑥	镥
鐓	镦
鑭	镧
鐠	镨
鑹	镩
鏹	镪
鐙	镫
鑊	镬
鐳	镭
鐶	镮
鐲	镯
鐮	镰
鎌	镰
鐿	镱
鑔	镲
鑣	镳
鑞	镴
鑱	镵
鑲	镶
長	长
門	门
閂	闩
閃	闪
閆	闫
閈	闬
閉	闭
問	问
闖	闯
閏	闰
闈	闱
閒	闲
閑	闲
閎	闳
間	间
閔	闵
閌	闶
悶	闷
閘	闸
鬧	闹
閨	闺
聞	闻
闥	闼
閩	闽
閭	闾
闓	闿
閥	阀
閣	阁
閡	阂
閫	阃
鬮	阄
閱	阅
閬	阆
闍	阇
閾	阈
閹	阉
閶	阊
鬩	阋
閿	阌
閽	阍
閻	阎
閼	阏
闡	阐
闌	阑
闃	阒
闠	阓
闊	阔
闋	阕
闔	阖
闐	阗
闒	阘
闕	阙
闞	阚
闤	阛
隊	队
陽	阳
陰	阴
陣	阵
階	阶
際	际
陸	陆
隴	陇
陳	陈
陘	陉
陝	陕
隯	陦
隉	陧
隕	陨
険	险
隠	隐
隷	隶
雋	隽
難	难
僱	雇
雛	雏
鵰	雕
讎	雠
靂	雳
霧	雾
霽	霁
黴	霉
霢	霡
靄	霭
靚	靓
靝	靔
麪	面
靨	靥
韃	鞑
鞽	鞒
韉	鞯
韝	鞲
韋	韦
韌	韧
韍	韨
韓	韩
韙	韪
韞	韫
韜	韬
韻	韵
頁	页
頂	顶
頃	顷
頇	顸
項	项
順	顺
須	须
鬚	须
頊	顼
頑	顽
顧	顾
頓	顿
頎	颀
頒	颁
頌	颂
頏	颃
預	预
顱	颅
領	领
頗	颇
頸	颈
頡	颉
頰	颊
頲	颋
頜	颌
潁	颍
熲	颎
頦	颏
頤	颐
頻	频
頮	颒
頹	颓
頷	颔
頴	颕
穎	颖
顆	颗
題	题
顒	颙
顎	颚
顓	颛
顔	颜
額	额
顳	颞
顢	颟
顛	颠
顙	颡
顥	颢
纇	颣
顫	颤
顬	颥
顰	颦
顴	颧
風	风
颺	飏
颭	飐
颮	飑
颯	飒
颶	飓
颸	飔
颼	飕
颻	飖
飀	飗
飄	飘
飆	飙
飈	飚
飛	飞
饗	飨
饜	餍
飠	饣
飣	饤
飢	饥
饑	饥
飥	饦
餳	饧
飩	饨
餼	饩
飪	饪
飫	饫
飭	饬
飯	饭
飲	饮
餞	饯
飾	饰
飽	饱
飼	饲
飿	饳
飴	饴
餌	饵
饒	饶
餉	饷
餄	饸
餎	饹
餃	饺
餏	饻
餅	饼
餑	饽
餖	饾
餓	饿
余	馀
餒	馁
餕	馂
餜	馃
餛	馄
餡	馅
館	馆
餷	馇
饋	馈
餶	馉
餿	馊
饞	馋
饁	馌
饃	馍
餺	馎
餾	馏
饈	馐
饉	馑
饅	馒
饊	馓
饌	馔
饢	馕
馬	马
馭	驭
馱	驮
馴	驯
馳	驰
駆	驱
馹	驲
駁	驳
驢	驴
駔	驵
駛	驶
駟	驷
駙	驸
駒	驹
騶	驺
駐	驻
駝	驼
駑	驽
駕	驾
駅	驿
駘	骀
驍	骁
罵	骂
駰	骃
驕	骄
驊	骅
駱	骆
駭	骇
駢	骈
驫	骉
驪	骊
騁	骋
験	验
騂	骍
駸	骎
駿	骏
騏	骐
騎	骑
騍	骒
騅	骓
騌	骔
驌	骕
驂	骖
騙	骗
騭	骘
騤	骙
騒	骚
騖	骛
驁	骜
騮	骝
騫	骞
騸	骟
驃	骠
騾	骡
驄	骢
驏	骣
驟	骤
驥	骥
驦	骦
驤	骧
髏	髅
髖	髋
髕	髌
鬢	鬓
鬹	鬶
魘	魇
魎	魉
魚	鱼
魛	鱽
魢	鱾
魷	鱿
魨	鲀
魯	鲁
魴	鲂
䰾	鲃
魺	鲄
鮁	鲅
鮃	鲆
鮎	鲇
鱸	鲈
鮋	鲉
鮓	鲊
鮒	鲋
鮊	鲌
鮑	鲍
鱟	鲎
鮍	鲏
鮐	鲐
鮭	鲑
鮚	鲒
鮳	鲓
鮪	鲔
鮞	鲕
鮦	鲖
鰂	鲗
鮜	鲘
鱠	鲙
鱭	鲚
鮫	鲛
鮮	鲜
鮺	鲝
鯗	鲞
鱘	鲟
鯁	鲠
鱺	鲡
鰱	鲢
鰹	鲣
鯉	鲤
鰣	鲥
鰷	鲦
鯀	鲧
鯊	鲨
鯇	鲩
鮶	鲪
鯽	鲫
鯒	鲬
鯖	鲭
鯪	鲮
鯕	鲯
鯫	鲰
鯡	鲱
鯤	鲲
鯧	鲳
鯝	鲴
鯢	鲵
鮎	鲶
鯰	鲶
鯛	鲷
鯨	鲸
鰺	鲹
鯴	鲺
鯔	鲻
鱝	鲼
鰈	鲽
鰏	鲾
鱨	鲿
鯷	鳀
鰮	鳁
鰛	鳁
鰃	鳂
鰓	鳃
鱷	鳄
鰍	鳅
鰒	鳆
鰉	鳇
鰁	鳈
鱂	鳉
鯿	鳊
鰠	鳋
鰲	鳌
鰭	鳍
鰨	鳎
鰥	鳏
鰩	鳐
鰟	鳑
鰜	鳒
鰳	鳓
鰾	鳔
鱈	鳕
鱉	鳖
鰻	鳗
鰵	鳘
鱅	鳙
䲁	鳚
鰼	鳛
鱖	鳜
鱔	鳝
鱗	鳞
鱒	鳟
鱯	鳠
鱤	鳡
鱧	鳢
鱣	鳣
䲘	鳤
鳥	鸟
鳩	鸠
雞	鸡
鳶	鸢
鳴	鸣
鳲	鸤
鷗	鸥
鴉	鸦
鶬	鸧
鴇	鸨
鴆	鸩
鴣	鸪
鶇	鸫
鸕	鸬
鴨	鸭
鴞	鸮
鴦	鸯
鴒	鸰
鴟	鸱
鴝	鸲
鴛	鸳
鷽	鸴
鴕	鸵
鷥	鸶
鷙	鸷
鴯	鸸
鴰	鸹
鵂	鸺
鴴	鸻
鵃	鸼
鴿	鸽
鸞	鸾
鴻	鸿
鵐	鹀
鵓	鹁
鸝	鹂
鵑	鹃
鵠	鹄
鵝	鹅
鵒	鹆
鷳	鹇
鷴	鹇
鵜	鹈
鵡	鹉
鵲	鹊
鶓	鹋
鵪	鹌
鵾	鹍
鵯	鹎
鵬	鹏
鵮	鹐
鶉	鹑
鶊	鹒
鵷	鹓
鷫	鹔
鶘	鹕
鶡	鹖
鶚	鹗
鶻	鹘
鶖	鹙
鶿	鹚
鶥	鹛
鶩	鹜
鷊	鹝
鷂	鹞
鶲	鹟
鶹	鹠
鶺	鹡
鷁	鹢
鶼	鹣
鶴	鹤
鷖	鹥
鸚	鹦
鷓	鹧
鷚	鹨
鷯	鹩
鷦	鹪
鷲	鹫
鷸	鹬
鷺	鹭
䴉	鹮
鸇	鹯
鷹	鹰
鸌	鹱
鸏	鹲
鸛	鹳
鸘	鹴
鹺	鹾
麩	麸
麴	麹
麪	麺
麼	麽
黃	黄
黌	黉
黶	黡
黷	黩
黲	黪
黽	黾
黿	鼋
鼂	鼌
鼉	鼍
鞀	鼗
鼴	鼹
齇	齄
斉	齐
齏	齑
歯	齿
齔	龀
齕	龁
齗	龂
齟	龃
齢	龄
齙	龅
齠	龆
齜	龇
齦	龈
齬	龉
齪	龊
齲	龋
齷	龌
竜	龙
龔	龚
龕	龛
龜	龟
𠁞	𠀾
儣	𠆲
𠌥	𠆿
俓	𠇹
㒓	𠉂
𠏢	𠉗
𣍐	𠊉
儭	𠋆
𠠎	𠚳
剾	𠛅
𠞆	𠛆
𪟖	𠛾
勑	𠡠
嗰	𠮶
哯	𠯟
噅	𠯠
㘉	𠰱
嚧	𠰷
囃	𠱞
𡅏	𠲥
𡃕	𠴛
𡄔	𠴢
𡄣	𠵸
㗲	𠵾
𡓾	𡋀
𡑭	𡋗
壗	𡋤
𡔖	𡍣
壈	𡒄
㜷	𡝠
㜗	𡞋
㜢	𡞱
孎	𡠟
孻	𡥧
𡮉	𡭜
𡮣	𡭬
𡳳	𡳃
𦘧	𡳒
嵼	𡶴
𡽗	𡸃
嶈	𡺃
嶘	𡺄
㢝	𢋈
㦛	𢗓
𢤱	𢘙
𢣚	𢘝
𢣭	𢘞
愻	𢙏
憹	𢙐
𢠼	𢙑
憢	𢙒
懀	𢙓
㦎	𢛯
懎	𢠁
𤢻	𢢐
戦	𢧐
𢷮	𢫊
𢶫	𢫞
摋	𢫬
擫	𢬍
𢹿	𢬦
擣	𢭏
斅	𢽾
斸	𣃁
曥	𣆐
𣋋	𣈣
𦢈	𣍨
腪	𣍯
脥	𣍰
臗	𣎑
槫	𣏢
桱	𣐕
欍	𣐤
𣠲	𣑶
楇	𣒌
橯	𣓿
樤	𣔌
樠	𣗊
欓	𣗋
㰙	𣗙
㯤	𣘐
𣞻	𣘓
檭	𣘴
𣝕	𣘷
欘	𣚚
𣠩	𣞎
殢	𣨼
𣯴	𣭤
𣯩	𣯣
氭	𣱝
湋	𣲗
潕	𣲘
㵗	𣳆
澅	𣶩
𣿉	𣶫
𪷓	𣶭
𤅶	𣷷
濆	𣸣
灙	𣺼
𤁣	𣺽
瀃	𣽷
熓	𤆡
㷍	𤆢
爄	𤇃
熌	𤇄
爖	𤇭
熚	𤇹
熉	𤈶
㷿	𤈷
𤒎	𤊀
𤓩	𤊰
熡	𤋏
㸇	𤎺
𤑳	𤎻
𤛮	𤙯
𤢟	𤝢
獩	𤞃
玁	𤞤
㺏	𤠋
瓕	𤦀
瓛	𤩽
𤳸	𤳄
癐	𤶊
𤸫	𤶧
㿗	𤻊
㿧	𤽯
皟	𤾀
麬	𤿲
䀉	𥁢
𥌃	𥅘
䀹	𥅴
𥊝	𥅿
瞤	𥆧
䁪	𥇢
䂎	𥎝
礒	𥐟
𥖅	𥐯
𥕥	𥐰
碙	𥐻
𥞵	𥞦
𥨐	𥧂
竚	𥩟
𥪂	𥩺
籅	𥫣
䉙	𥬀
籋	𥬞
篘	𥬠
𥵊	𥭉
𥸠	𥮋
䉲	𥮜
篸	𥮾
𥵃	𥱔
𥼽	𥹥
䊭	𥺅
𥽖	𥺇
𥿊	𦈈
緷	𦈉
綇	𦈋
綀	𦈌
繟	𦈎
緍	𦈏
縺	𦈐
緸	𦈑
𦂅	𦈒
䋿	𦈓
縎	𦈔
緰	𦈕
䌈	𦈖
𦃄	𦈗
䌋	𦈘
䌰	𦈙
縬	𦈚
繓	𦈛
䌖	𦈜
繏	𦈝
䌟	𦈞
䌝	𦈟
䌥	𦈠
繻	𦈡
䍽	𦍠
朥	𦛨
膢	𦝼
𦣎	𦟗
𦪽	𦨩
蓧	𦰏
䕳	𦰴
爇	𦶟
𦾟	𦶻
蘟	𦻕
檾	𦼖
𧕟	𧉐
䗿	𧉞
𧎈	𧌥
蠙	𧏖
蠀	𧏗
蠾	𧑏
𧔥	𧒭
䙱	𧜭
襰	𧝝
𧟀	𧝧
詀	𧮪
𧳟	𧳕
䞈	𧹑
買	𧹒
𧶔	𧹓
賬	𧹔
䝻	𧹕
賟	𧹖
贃	𧹗
𨇁	𧿈
躘	𨀁
𨄣	𨀱
𨅍	𨁴
𨈊	𨂺
𨈌	𨄄
䠱	𨅛
𨇞	𨅫
躝	𨅬
軉	𨉗
軗	𨐅
𨊻	𨐆
𨏠	𨐇
輄	𨐈
𨎮	𨐉
𨏥	𨐊
䢨	𨑹
𨣞	𨟳
𨣧	𨠨
𨢿	𨡙
𨣈	𨡺
𨤻	𨤰
鎷	𨰾
釳	𨰿
𨥛	𨱀
鈠	𨱁
鈋	𨱂
鈲	𨱃
鈯	𨱄
鉁	𨱅
龯	𨱆
銶	𨱇
鋉	𨱈
鍄	𨱉
𨧱	𨱊
錂	𨱋
鏆	𨱌
鎯	𨱍
鍮	𨱎
鎝	𨱏
𨫒	𨱐
鐄	𨱑
鏉	𨱒
鐎	𨱓
鐏	𨱔
𨮂	𨱕
䥩	𨱖
䦳	𨷿
𨳕	𨸀
𨳑	𨸁
閍	𨸂
閐	𨸃
䦘	𨸄
𨴗	𨸅
𨵩	𨸆
𨵸	𨸇
𨶀	𨸉
𨶏	𨸊
𨶲	𨸋
𨶮	𨸌
𨷲	𨸎
𨽏	𨸘
䧢	𨸟
䪏	𩏼
𩏪	𩏽
𩎢	𩏾
䪘	𩏿
䪗	𩐀
顂	𩓋
𩓣	𩖕
顃	𩖖
䫴	𩖗
颰	𩙥
𩗀	𩙦
䬞	𩙧
𩘹	𩙨
𩘀	𩙩
颷	𩙪
颾	𩙫
𩘺	𩙬
𩘝	𩙭
䬘	𩙮
䬝	𩙯
𩙈	𩙰
𩚛	𩟿
𩚥	𩠀
𩚵	𩠁
𩛆	𩠂
𩛩	𩠃
𩟐	𩠅
𩜦	𩠆
䭀	𩠇
䭃	𩠈
𩜇	𩠉
𩜵	𩠊
𩝔	𩠋
餸	𩠌
𩞄	𩠎
𩞦	𩠏
𩠴	𩠠
𩡣	𩡖
𩡺	𩧦
駎	𩧨
𩤊	𩧩
䮾	𩧪
駚	𩧫
𩢡	𩧬
䭿	𩧭
𩢾	𩧮
驋	𩧯
䮝	𩧰
𩥉	𩧱
駧	𩧲
𩢸	𩧳
駩	𩧴
𩢴	𩧵
𩣏	𩧶
𩣫	𩧸
駶	𩧺
𩣵	𩧻
𩣺	𩧼
䮠	𩧿
騔	𩨀
䮞	𩨁
驄	𩨂
騝	𩨃
騪	𩨄
𩤸	𩨅
𩤙	𩨆
䮫	𩨇
騟	𩨈
𩤲	𩨉
騚	𩨊
𩥄	𩨋
𩥑	𩨌
𩥇	𩨍
龭	𩨎
䮳	𩨏
𩧆	𩨐
䯤	𩩈
𩭙	𩬣
𩰀	𩬤
鬖	𩭹
𩯳	𩯒
𩰹	𩰰
𩳤	𩲒
𩴵	𩴌
魥	𩽹
𩵩	𩽺
𩵹	𩽻
鯶	𩽼
𩶱	𩽽
鮟	𩽾
𩶰	𩽿
鮕	𩾀
鯄	𩾁
䲖	𩾂
鮸	𩾃
𩷰	𩾄
𩸃	𩾅
𩸦	𩾆
鯱	𩾇
䱙	𩾈
䱬	𩾊
䱰	𩾋
鱇	𩾌
𩽇	𩾎
䲰	𪉂
鳼	𪉃
𩿪	𪉄
𪀦	𪉅
鴲	𪉆
鴜	𪉈
𪁈	𪉉
鷨	𪉊
𪀾	𪉋
𪁖	𪉌
鵚	𪉍
𪂆	𪉎
𪃏	𪉏
𪃍	𪉐
鷔	𪉑
𪄕	𪉒
𪈼	𪉓
𪄆	𪉔
𪇳	𪉕
䴬	𪎈
麲	𪎉
麨	𪎊
䴴	𪎋
麳	𪎌
𪋿	𪎍
䵳	𪑅
𪔵	𪔭
𪘀	𪚏
𪘯	𪚐
𠿕	𪜎
凙	𪞝
㔋	𪟎
勣	𪟝
𧷎	𪠀
㓄	𪠟
𠬙	𪠡
唓	𪠳
㖮	𪠵
嚛	𪠸
𠽃	𪠺
噹	𪠽
嘺	𪡀
嘪	𪡃
噞	𪡋
嗹	𪡏
㗿	𪡛
嘳	𪡞
𡃄	𪡺
㘓	𪢌
𡃤	𪢐
𡂡	𪢒
嚽	𪢕
𡅯	𪢖
囒	𪢠
圞	𪢮
墲	𪢸
埬	𪣆
堚	𪣒
塿	𪣻
𡓁	𪤄
壣	𪤚
𧹈	𪥠
孇	𪥫
嬣	𪥰
嬻	𪥿
孾	𪧀
寠	𪧘
㞞	𪨊
屩	𪨗
崙	𪨧
𡸗	𪨩
輋	𪨶
巗	𪨷
𡹬	𪨹
㟺	𪩇
巊	𪩎
巘	𪩘
𡿖	𪩛
幝	𪩷
幩	𪩸
廬	𪪏
㢗	𪪑
廧	𪪞
𢍰	𪪴
彃	𪪼
徿	𪫌
𢤩	𪫡
㦞	𪫷
憸	𪫺
𢣐	𪬚
𢤿	𪬯
𢯷	𪭝
摐	𪭢
擟	𪭧
𢶒	𪭯
掚	𪭵
撊	𪭾
㨻	𪮃
㩋	𪮋
撧	𪮖
𢺳	𪮳
攋	𪮶
㪎	𪯋
曊	𪰶
膹	𪱥
梖	𪱷
櫅	𪲎
欐	𪲔
檵	𪲛
櫠	𪲮
欇	𪳍
𣜬	𪳗
欑	𪴙
毊	𪵑
霼	𪵣
濿	𪵱
溡	𪶄
𤄷	𪶒
𣽏	𪶮
㵾	𪷍
灒	𪷽
熂	𪸕
煇	𪸩
𤑹	𪹀
𤓌	𪹠
爥	𪹳
𤒻	𪹹
𤘀	𪺣
𤜆	𪺪
犞	𪺭
獊	𪺷
𤠮	𪺸
㺜	𪺻
猌	𪺽
瑽	𪻐
瓄	𪻨
瑻	𪻲
璝	𪻺
㻶	𪼋
𤬅	𪼴
畼	𪽈
𤳷	𪽝
痮	𪽪
𤷃	𪽭
㿖	𪽮
𤺔	𪽴
瘱	𪽷
盨	𪾔
睍	𪾢
眝	𪾣
矑	𪾦
矉	𪾸
𥏝	𪿊
𥖲	𪿞
礮	𪿫
𥗇	𪿵
𥜰	𫀌
𥜐	𫀓
䅐	𫀨
䅳	𫀬
𥢷	𫀮
䆉	𫁂
竱	𫁟
鴗	𫁡
𥶽	𫁱
䉑	𫁲
𥯤	𫁳
䉶	𫁷
𥴼	𫁺
簢	𫂃
簂	𫂆
䉬	𫂈
𥴨	𫂖
𥻦	𫂿
𩏷	𫃗
糺	𫄙
䊺	𫄚
紟	𫄛
䋃	𫄜
𥾯	𫄝
䋔	𫄞
絁	𫄟
絙	𫄠
絧	𫄡
絥	𫄢
繷	𫄣
繨	𫄤
纚	𫄥
𦀖	𫄦
綖	𫄧
絺	𫄨
䋦	𫄩
𦅇	𫄪
綟	𫄫
緤	𫄬
緮	𫄭
䋼	𫄮
𦃩	𫄯
縍	𫄰
繬	𫄱
縸	𫄲
縰	𫄳
繂	𫄴
𦅈	𫄵
繈	𫄶
繶	𫄷
纁	𫄸
纗	𫄹
䍤	𫅅
羵	𫅗
𦒀	𫅥
䎙	𫅭
𦔖	𫅼
聻	𫆏
𦟼	𫆝
𦡝	𫆫
𦧺	𫇘
艣	𫇛
𦱌	𫇪
蔿	𫇭
蒭	𫇴
蕽	𫇽
蕳	𫈉
葝	𫈎
蔯	𫈟
蕝	𫈵
薆	𫉁
藷	𫉄
䗅	𫊪
蠦	𫊮
蟜	𫊸
𧒯	𫊹
蟳	𫊻
蟂	𫋇
蟘	𫋌
䙔	𫋲
襗	𫋷
襓	𫋹
襘	𫋻
襀	𫌀
襵	𫌇
𧞫	𫌋
覼	𫌨
覛	𫌪
𧡴	𫌫
𧢄	𫌬
覹	𫌭
䚩	𫌯
𧭹	𫍐
訑	𫍙
訞	𫍚
訜	𫍛
詓	𫍜
諫	𫍝
𧦝	𫍞
𧦧	𫍟
䛄	𫍠
詑	𫍡
譊	𫍢
詷	𫍣
譑	𫍤
誂	𫍥
譨	𫍦
誺	𫍧
誫	𫍨
諣	𫍩
誋	𫍪
䛳	𫍫
誷	𫍬
𧩕	𫍭
誳	𫍮
諴	𫍯
諰	𫍰
諯	𫍱
謏	𫍲
諥	𫍳
謱	𫍴
謸	𫍵
𧩼	𫍶
謉	𫍷
謆	𫍸
謯	𫍹
𧫝	𫍺
譆	𫍻
𧬤	𫍼
譞	𫍽
𧭈	𫍾
譾	𫍿
豵	𫎆
貗	𫎌
贚	𫎦
䝭	𫎧
𧸘	𫎨
賝	𫎩
䞋	𫎪
贉	𫎫
贑	𫎬
䞓	𫎭
䟐	𫎱
䟆	𫎳
𧽯	𫎸
䟃	𫎺
䠆	𫏃
蹳	𫏆
蹻	𫏋
𨂐	𫏌
蹔	𫏐
𨇽	𫏑
𨆪	𫏕
𨇰	𫏞
𨇤	𫏨
軏	𫐄
軕	𫐅
轣	𫐆
軜	𫐇
軷	𫐈
軨	𫐉
軬	𫐊
𨎌	𫐋
軿	𫐌
𨌈	𫐍
輢	𫐎
輖	𫐏
輗	𫐐
輨	𫐑
輷	𫐒
輮	𫐓
𨍰	𫐔
轊	𫐕
轇	𫐖
轐	𫐗
轗	𫐘
轠	𫐙
遱	𫐷
鄟	𫑘
鄳	𫑡
醶	𫑷
釟	𫓥
釨	𫓦
鈇	𫓧
鈛	𫓨
鏦	𫓩
鈆	𫓪
𨥟	𫓫
鉔	𫓬
鉠	𫓭
𨪕	𫓮
銈	𫓯
銊	𫓰
鐈	𫓱
銁	𫓲
𨰋	𫓳
鉾	𫓴
鋠	𫓵
鋗	𫓶
𫒡	𫓷
錽	𫓸
錤	𫓹
鐪	𫓺
錜	𫓻
𨨛	𫓼
錝	𫓽
錥	𫓾
𨨢	𫓿
鍊	𫔀
鐼	𫔁
鍉	𫔂
𨰲	𫔃
鍒	𫔄
鎍	𫔅
䥯	𫔆
鎞	𫔇
鎙	𫔈
𨰃	𫔉
鏥	𫔊
䥗	𫔋
鏾	𫔌
鐇	𫔍
鐍	𫔎
𨬖	𫔏
𨭸	𫔐
𨭖	𫔑
𨮳	𫔒
𨯟	𫔓
鑴	𫔔
𨰥	𫔕
𨲳	𫔖
開	𫔭
閒	𫔮
閗	𫔯
閞	𫔰
𨴹	𫔲
閵	𫔴
䦯	𫔵
闑	𫔶
𨼳	𫔽
𩀨	𫕚
霣	𫕥
𩅙	𫕨
靧	𫖃
䪊	𫖅
鞾	𫖇
𩎖	𫖑
韠	𫖒
𩏂	𫖓
韛	𫖔
韝	𫖕
𩏠	𫖖
𩑔	𫖪
䪴	𫖫
䪾	𫖬
𩒎	𫖭
顗	𫖮
頫	𫖯
䫂	𫖰
䫀	𫖱
䫟	𫖲
頵	𫖳
𩔳	𫖴
𩓥	𫖵
顅	𫖶
𩔑	𫖷
願	𫖸
顣	𫖹
䫶	𫖺
䫻	𫗇
𩗓	𫗈
𩗴	𫗉
䬓	𫗊
飋	𫗋
𩟗	𫗚
飦	𫗞
䬧	𫗟
餦	𫗠
𩚩	𫗡
飵	𫗢
飶	𫗣
𩛌	𫗤
餫	𫗥
餔	𫗦
餗	𫗧
𩛡	𫗨
饠	𫗩
餧	𫗪
餬	𫗫
餪	𫗬
餵	𫗭
餭	𫗮
餱	𫗯
䭔	𫗰
䭑	𫗱
𩝽	𫗳
饘	𫗴
饟	𫗵
馯	𫘛
馼	𫘜
駃	𫘝
駞	𫘞
駊	𫘟
駤	𫘠
駫	𫘡
駻	𫘣
騃	𫘤
騉	𫘥
騊	𫘦
騄	𫘧
騠	𫘨
騜	𫘩
騵	𫘪
騴	𫘫
騱	𫘬
騻	𫘭
䮰	𫘮
驓	𫘯
驙	𫘰
驨	𫘱
鬠	𫘽
𩯁	𫙂
鱮	𫚈
魟	𫚉
鰑	𫚊
鱄	𫚋
魦	𫚌
魵	𫚍
𩶁	𫚎
䱁	𫚏
䱀	𫚐
鮅	𫚑
鮄	𫚒
鮤	𫚓
鮰	𫚔
鰤	𫚕
鮆	𫚖
鮯	𫚗
𩻮	𫚘
鯆	𫚙
鮿	𫚚
鮵	𫚛
䲅	𫚜
𩸄	𫚝
鯬	𫚞
𩸡	𫚟
䱧	𫚠
鯞	𫚡
鰋	𫚢
鯾	𫚣
鰦	𫚤
鰕	𫚥
鰫	𫚦
鰽	𫚧
𩻗	𫚨
𩻬	𫚩
鱊	𫚪
鱢	𫚫
𩼶	𫚬
鱲	𫚭
鳽	𫛚
鳷	𫛛
鴀	𫛜
鴅	𫛝
鴃	𫛞
鸗	𫛟
𩿤	𫛠
鴔	𫛡
鸋	𫛢
鴥	𫛣
鴐	𫛤
鵊	𫛥
鴮	𫛦
𪀖	𫛧
鵧	𫛨
鴳	𫛩
鴽	𫛪
鶰	𫛫
䳜	𫛬
鵟	𫛭
䳤	𫛮
鶭	𫛯
䳢	𫛰
鵫	𫛱
鵰	𫛲
鵩	𫛳
鷤	𫛴
鶌	𫛵
鶒	𫛶
鶦	𫛷
鶗	𫛸
𪃧	𫛹
䳧	𫛺
𪃒	𫛻
䳫	𫛼
鷅	𫛽
𪆷	𫛾
鷐	𫜀
鷩	𫜁
𪅂	𫜂
鷣	𫜃
鷷	𫜄
䴋	𫜅
𪉸	𫜊
麷	𫜑
䴱	𫜒
𪌭	𫜓
䴽	𫜔
𪍠	𫜕
䵴	𫜙
𪓰	𫜟
䶕	𫜨
齧	𫜩
齩	𫜪
𫜦	𫜫
齰	𫜬
齭	𫜭
齴	𫜮
𪙏	𫜯
齾	𫜰
龓	𫜲
䶲	𫜳
㑮	𫝈
𠐊	𫝋
㛝	𫝦
㜐	𫝧
媈	𫝨
嬦	𫝩
𡟫	𫝪
婡	𫝫
嬇	𫝬
孆	𫝭
孄	𫝮
嶹	𫝵
𦠅	𫞅
潣	𫞗
澬	𫞚
㶆	𫞛
灍	𫞝
爧	𫞠
爃	𫞡
𤛱	𫞢
㹽	𫞣
珼	𫞥
璾	𫞦
𤩂	𫞧
璼	𫞨
璊	𫞩
𥢶	𫞷
絍	𫟃
綋	𫟄
綡	𫟅
緟	𫟆
𦆲	𫟇
䖅	𫟑
䕤	𫟕
訨	𫟞
詊	𫟟
譂	𫟠
誴	𫟡
䜖	𫟢
䡐	𫟤
䡩	𫟥
䡵	𫟦
𨞺	𫟫
𨟊	𫟬
釚	𫟲
釲	𫟳
鈖	𫟴
鈗	𫟵
銏	𫟶
鉝	𫟷
鉽	𫟸
鉷	𫟹
䤤	𫟺
銂	𫟻
鐽	𫟼
𨧰	𫟽
𨩰	𫟾
鎈	𫟿
䥄	𫠀
鑉	𫠁
閝	𫠂
韚	𫠅
頍	𫠆
𩖰	𫠇
䫾	𫠈
䮄	𫠊
騼	𫠋
𩦠	𫠌
𩵦	𫠏
魽	𫠐
䱸	𫠑
鱆	𫠒
𩿅	𫠖
齯	𫠜
